qué=what
quién=who
cuándo=when
dónde=where
por qué=why
cuál=which
cómo=how
disculpe=excuse me
lo siento=sorry
gracias=thank you
salud=bless you
de nada=you’re welcome
por favor=please
hola=hello
buenos días=good morning
buenas tardes=good afternoon
buenas noches=good evening
feliz cumpleaños=happy birthday
felicitaciones=congratulations
diviértete=have fun
buen provecho=bon appetit
bienvenidos=welcome
salud=cheers
adiós=goodbye
chao=goodbye
Domingo=Sunday
Lunes=Monday
Martes=Tuesday
Miércoles=Wednesday
Jueves=Thursday
Viernes=Friday
Sabado=Saturday
Enero=January
Febrero=February
Marzo=March
Abril=April
Mayo=May
Junio=June
Julio=July
Agosto=August
Septiembre=September
Octubre=October
Noviembre=November
Diciembre=December
el padre=father
el papá=dad
la madre=mother
la mamá=mom
el hermano=brother
la hermana=sister
el hijo=son
la hija=daughter
el abuelo=grandfather
la abuela=grandmother
la nieta=granddaughter
el nieto=grandson
el tío=uncle
la tía=aunt
el primo=cousin (male)
la prima=cousin (female)
negro=black
café=brown
gris=grey
blanco=white
amarillo=yellow
anaranjado=orange
rojo=red
rosado=pink
púrpura=purple
azul=blue
verde=green
cero=zero
uno=one
dos=two
tres=three
cuatro=four
cinco=five
seis=six
siete=seven
ocho=eight
nueve=nine
diez=ten
el gato=cat
el perro=dog
el conejo=rabbit
el pollo=chicken
la gallina=hen
el gallo=rooster
la vaca=cow
el toro=bull
la oveja=sheep
el caballo=horse
el cerdo=pig
la cabra=goat
el burro=donkey
el ratón=mouse
el mapache=raccoon
la ardilla=squirrel
el búho=owl
el ciervo=deer